/*
    1.) max 10 rows (arrays) per Level
    2.) define 11 bricks per row
    3.) Bricktypes:
            - 0 = empty
            - 1 = Fastbrick (speed-powerup, 3 Hits)
            - 2 = Hardbrick (paddlewidth-powerup, 5 Hits)
            - else = Normal (5% chance to gain an extra-life, 1 Hit)
*/

levelEins=[
    [1,1,1,2,2,0,2,2,1,1,1], 
    [1,2,1,2,3,3,3,2,1,2,1], 
    [3,3,1,2,3,1,3,2,1,3,3]];

levelZwei=[
    [3,3,3,3,0,0,0,3,3,3,3], 
    [0,3,1,1,3,0,3,1,1,3,0], 
    [0,0,3,1,2,2,2,1,3,0,0],
    [0,3,1,1,3,0,3,1,1,3,0], 
    [3,3,3,3,0,0,0,3,3,3,3]];

levelDrei=[
    [0,0,3,3,0,0,0,3,3,0,0], 
    [0,3,1,1,3,0,3,1,1,3,0], 
    [3,1,2,2,1,3,1,2,2,1,3],
    [3,1,2,3,2,1,2,3,2,1,3],
    [0,3,1,2,3,2,3,2,1,3,0], 
    [0,0,3,1,2,3,2,1,3,0,0], 
    [0,0,0,3,1,2,1,3,0,0,0],
    [0,3,1,0,3,1,3,0,1,3,0], 
    [3,3,3,3,0,3,0,3,3,3,3]];